0000000000000000000000000
0000000000000000000000000
S111111111110000000000000
0000000000010000000000000
0000000000011111111000000
0000000000000000001000000
0000000000000000001000000
0000000000000000001000000
000000000000000000111111F
0000000000000000000000000
0000000000000000000000000