0000000000000000000000000
0000000000000000000000000
0000000000011111111000000
0000000000010000001000000
0000000000010000001000000
0000000000010000001000000
1111111111110000001111111
0000000000000000000000000
0000000000000000000000000
0000000000000000000000000
0000000000000000000000000