0000000000000000000000000
0000000000000000000000000
1111100000111111100000000
0000100000100000100000000
0000100000100000100000000
0000111111100000100000000
0000000000000000100000000
0000000000000000111111111
0000000000000000000000000
0000000000000000000000000
0000000000000000000000000