00S0000000000000000000000
0010000000000000000000000
0010000000000000000000000
0011111100000000000000000
0000000100000000000000000
0000000100000000000000000
0000000100000000000000000
0000000111111110000000000
0000000000000010000000000
0000000000000010000000000
000000000000001111111111F